##########
#........#
#........#
#....@...#
#........#
#........#
#........#
##########