............#...
......#.........
.....@...#......
..#.............
...........#....